111111111
111111111
100010001
1000P0001
1000E0011
111000111
1110C0111
111111111
11100C111
111000111
111000111
111000111
111000111
111000111
111000111
111101111
111111111