111111111
111111111
100010001
1000P0001
100000001
111000111
111000111
1110C0111
111000111
1110C0111
111000111
1110C0111
111000111
1110C0111
111000111
1111E1111
111111111