111111111
111111111
100010001
100000001
100000011
1110E0111
1110C0111
111000111
11100C111
111000111
111000111
111110111
1110P0111
111000111
111000111
111101111
111111111